##########################
#..#.#...#..###......##..e
##.#.##.##.##...#.##.##.##
#....#..#.....#.#.##....##
###.##.##.#####.#.##.##.##
#...........###.#.##.##.##
#####.###.#####.#.##.##.##
#...........###.#.##.##.##
##.#.##.##.####.#.##.##.##
#....#..#...###.#.##.##.##
###.##.##.#####.#.##.##.##
#...........###.#.##.##.##
#####.###.#####.#.##.##.##
x...........###.#.##.##.##
###############.#.##.##.##